NO ./assets/Images/bookshelf.xpm
SO ./assets/Images/bricks.xpm  
WE ./assets/Images/gemov.xpm
EA ./assets/Images/dirt.xpm  

F 200,200,200
C 0,0,0

        111111111111111111111111111
        1001000000110000000000001
        1011000001110010000000001
        10000000000000000W0000001
111111111011000001110000100000001
111111111011000001110000000000001
100000000011000001110111111111111
11110111111111011100000010001
11110111111111011101010010001
11000000110101011100000010001
10000000000000001100000001001
10000000000000001101010010001
1100000111010101111101111000111
11110111 1110101 101111010001
11111111 1111111 111111111111