NO ./assets/Images/bookshelf.xpm
SO ./assets/Images/bricks.xpm  
WE ./assets/Images/gemov.xpm
EA ./assets/Images/dirt.xpm  

F 120,25,25
C 120,25,80

        111111111111111111111111111
        1000000000110000000000001
        1011000001110000000000001
        10010000000000000N0000001
111111111011000001110000000000001
100000000011000001110111111111111
11110111111111011100000010001
11110111111111011101010010001
11000000110101011100000010001
10000000000000001100000001001
10000000000000001101010010001
1100000111010101111101111000111
11110111 1110101 101111010001
11111111 1111111 111111111111