NO ./assets/Images/north.xpm
SO ./assets/Images/south.xpm  
WE ./assets/Images/west.xpm
EA ./assets/Images/east.xpm  

F 200,200,200
C 0,0,0

1111111111111111111111
1000000000000000000001
1000000000000000000001
1000001010111000000001
1000001110001000000001
1000000010010000000001
1000000010111000000001
1011000000000000000001
1000000000000000000001
1000000000X0000000N001
1000000000000000000001
1111111111111111111111
