NO ./assets/Images/north.xpm
SO ./assets/Images/south.xpm  
WE ./assets/Images/west.xpm
EA ./assets/Images/east.xpm  

F 200,200,200
C 0,0,0

1111111111111111111
1000000000000000001
1000000000000000001
1000001010111000001
1000001110001000001
1000000010010000001
1000000010111000001
1000000000000000001
1000000000000000001
1111111111111111111
