NO ./assets/Images/north.xpm
SO ./assets/Images/north.xpm
WE ./assets/Images/north.xpm
EA ./assets/Images/north.xpm 

F 200,200,200
C 0,0,0

1111111111111111111111111111
1
1
1